kasra
kasra
(random generator)
Easy
8 8 14
-1 1 -2 -2 -3 -1 1 1 
1 3 -3 -2 -1 1 -3 -2 
-1 3 3 3 1 3 1 -3 
-1 2 3 -1 2 1 1 -1 
-1 3 2 2 -3 1 2 1 
-3 -1 -2 1 -2 -1 2 3 
-1 -3 2 -2 2 0 -1 0 
0 -2 0 0 -2 -3 2 -2 
